3 13 31
###############################
#p   ** **    *   2   b      3#
# # # #*# # # # # # # # # # # #
#*     ** *4*  *   * ** 2 *   #
# # # # # #*# # # # # # #*# # #
#*   *s*    ***4* x **        #
# # # # # # # # # # # # # #*# #
#    *     *  f   3 *    **  2#
# #*# # #*#*#*#*# # #1# # #*# #
#   s    *   *2*    *   *     #
#*# # # # # # # # # # #*# # #*#
# *    * **    ** ***     1   #
###############################