2 13 31
###############################
#p * *2       *  ** * *     4*#
# # # # #*# # #*# # # # # #*#4#
#    * * *** **      *    **  #
# #*# # # # #1# #b# # # # # #*#
# s        *     **      *  **#
# # #*# # # # # #*#*#*#*# # # #
#   *        *   * *x* *     3#
# # # # #*# # # # # # #*# #*# #
#   ****         *1      b    #
# # # # # # # # # #*# # # # #*#
#  ** *   *    2  f          3#
###############################