4 13 31
###############################
#p    * **   b*   2   1      3#
# # # #*# # # # # # # # # # # #
#   f  **4*4*  *   * ** 2 *   #
# # # # # #*# # # # # # #*# # #
#*   * *    *b* *   **        #
# # # # # # # # # # # # # #*# #
#    *     *    s   *    **  1#
# #*# # #*#*#*#*# # #1# # #*# #
#        * 1 *2*    *   *     #
#*# # # # # # # # # # #*# # #*#
#x* 3  * **    ** ***     1   #
###############################