5 13 31
###############################
#p * *1       *  ** * *     3*#
# # # # #*# # #*# # # # # #*# #
#    * * *** **  2   *    ** 4#
# #*# # # # #3# #b#1# # # # #*#
#    s     *     **      *  **#
# # #*# # # # # #*#*#*#*# # # #
#   *        *   * *x*4*   1  #
# # # # #*# # # # # # #*# #*# #
#   ****         *2    b      #
# # # # # # # # # #*# # # # #*#
#  ** *1  *    2         f    #
###############################